#################
#S      #       #
# ##### # ##### #
# #   # # #   # #
# # # # # # # # #
#   #   #   #   #
##### ##### #####
#           #  E#
#################