###############
#S            #
# ########### #
# #         # #
# # ####### # #
# # #E    # # #
# # ####### # #
# #         # #
###############