###################
#S    #     #     #
##### # ### # ### #
#     #   # #   # #
# ####### # ### # #
#         #     #E#
###################