###########
#S    #   #
##### # # #
#   #   # #
# ####### #
#       #E#
###########